//MAP CONVERTED BY dmm2tgm.py THIS HEADER COMMENT PREVENTS RECONVERSION, DO NOT REMOVE
"ag" = (
/obj/machinery/computer/slot_machine,
/obj/machinery/light/red/dim/directional/east,
/turf/open/floor/iron/dark/side{
	dir = 5
	},
/area/ruin/space/has_grav/powered/speakeasy)
"aV" = (
/turf/closed/wall,
/area/ruin/space/has_grav/powered/speakeasy)
"bP" = (
/obj/structure/chair/sofa/corp/right{
	dir = 4
	},
/turf/open/floor/carpet/green,
/area/ruin/space/has_grav/powered/speakeasy)
"bY" = (
/mob/living/basic/trooper/pirate/melee,
/obj/structure/chair/stool/directional/north,
/turf/open/floor/carpet/red,
/area/ruin/space/has_grav/powered/speakeasy)
"ch" = (
/obj/structure/chair/sofa/corp,
/turf/open/floor/carpet/green,
/area/ruin/space/has_grav/powered/speakeasy)
"cm" = (
/obj/structure/chair/stool/directional/west,
/turf/open/floor/iron/dark/side{
	dir = 5
	},
/area/ruin/space/has_grav/powered/speakeasy)
"cU" = (
/obj/structure/chair/sofa/corp/corner{
	dir = 4
	},
/turf/open/floor/carpet/green,
/area/ruin/space/has_grav/powered/speakeasy)
"dh" = (
/turf/open/floor/light/colour_cycle/dancefloor_b,
/area/ruin/space/has_grav/powered/speakeasy)
"dr" = (
/mob/living/basic/looter,
/obj/structure/chair/sofa/corp/right{
	dir = 4
	},
/turf/open/floor/carpet/red,
/area/ruin/space/has_grav/powered/speakeasy)
"dw" = (
/obj/machinery/light/small/directional/north,
/turf/open/floor/wood/tile,
/area/ruin/space/has_grav/powered/speakeasy)
"dT" = (
/obj/structure/chair/stool/directional/north,
/turf/open/floor/carpet/red,
/area/ruin/space/has_grav/powered/speakeasy)
"eK" = (
/turf/open/floor/iron/dark/side{
	dir = 5
	},
/area/ruin/space/has_grav/powered/speakeasy)
"eN" = (
/turf/open/floor/wood/large,
/area/ruin/space/has_grav/powered/speakeasy)
"fs" = (
/obj/machinery/light/small/directional/north,
/turf/open/floor/plating,
/area/ruin/space/has_grav/powered/speakeasy)
"gw" = (
/obj/effect/spawner/structure/window/reinforced,
/turf/open/floor/plating,
/area/ruin/space/has_grav/powered/speakeasy)
"gA" = (
/obj/machinery/door/airlock/maintenance,
/turf/open/floor/plating,
/area/ruin/space/has_grav/powered/speakeasy)
"gZ" = (
/turf/open/floor/iron/checker,
/area/ruin/space/has_grav/powered/speakeasy)
"hD" = (
/obj/structure/table/reinforced/plastitaniumglass,
/turf/open/floor/circuit/red,
/area/ruin/space/has_grav/powered/speakeasy)
"jL" = (
/turf/open/floor/grass/airless,
/area/ruin/space/has_grav/powered/speakeasy)
"kI" = (
/mob/living/basic/trooper/syndicate/melee/sword/anthro,
/turf/open/floor/iron/dark/smooth_edge{
	dir = 1
	},
/area/ruin/space/has_grav/powered/speakeasy)
"lN" = (
/obj/structure/chair/sofa/corp/left{
	dir = 8
	},
/turf/open/floor/carpet/red,
/area/ruin/space/has_grav/powered/speakeasy)
"lV" = (
/turf/open/floor/wood/parquet,
/area/ruin/space/has_grav/powered/speakeasy)
"mq" = (
/obj/machinery/computer/slot_machine,
/obj/machinery/light/red/dim/directional/west,
/turf/open/floor/iron/dark/side{
	dir = 10
	},
/area/ruin/space/has_grav/powered/speakeasy)
"nW" = (
/mob/living/basic/trooper/syndicate/ranged/smg/anthro,
/turf/open/floor/iron/checker,
/area/ruin/space/has_grav/powered/speakeasy)
"op" = (
/obj/machinery/light/red/dim/directional/west,
/turf/open/floor/iron,
/area/ruin/space/has_grav/powered/speakeasy)
"oD" = (
/obj/machinery/light/red/dim/directional/south,
/turf/open/floor/wood,
/area/ruin/space/has_grav/powered/speakeasy)
"oQ" = (
/turf/closed/mineral/random/asteroid,
/area/ruin/unpowered/no_grav)
"pB" = (
/obj/structure/chair/sofa/corp/corner{
	dir = 4
	},
/turf/open/floor/mineral/plastitanium/red,
/area/ruin/space/has_grav/powered/speakeasy)
"qM" = (
/turf/open/floor/iron/dark,
/area/ruin/space/has_grav/powered/speakeasy)
"ro" = (
/turf/closed/wall/r_wall,
/area/ruin/space/has_grav/powered/speakeasy)
"rr" = (
/obj/machinery/door/airlock/public,
/turf/open/floor/iron/dark,
/area/ruin/space/has_grav/powered/speakeasy)
"rD" = (
/obj/machinery/light/floor,
/turf/open/floor/carpet/red,
/area/ruin/space/has_grav/powered/speakeasy)
"sa" = (
/mob/living/basic/trooper/syndicate/melee/anthro,
/obj/structure/chair/sofa/corp/left{
	dir = 8
	},
/turf/open/floor/carpet/green,
/area/ruin/space/has_grav/powered/speakeasy)
"sN" = (
/obj/machinery/light/small/directional/east,
/turf/open/floor/iron,
/area/ruin/space/has_grav/powered/speakeasy)
"tj" = (
/obj/structure/chair/sofa/corp{
	dir = 1
	},
/turf/open/floor/mineral/plastitanium/red,
/area/ruin/space/has_grav/powered/speakeasy)
"uv" = (
/mob/living/basic/trooper/russian/ranged,
/obj/structure/chair/stool/directional/north,
/turf/open/floor/carpet/red,
/area/ruin/space/has_grav/powered/speakeasy)
"uJ" = (
/mob/living/basic/trooper/russian/ranged,
/obj/structure/chair/sofa/corp/left{
	dir = 8
	},
/turf/open/floor/carpet/green,
/area/ruin/space/has_grav/powered/speakeasy)
"uP" = (
/turf/open/floor/iron/dark/smooth_edge,
/area/ruin/space/has_grav/powered/speakeasy)
"vy" = (
/obj/machinery/light/red/dim/directional/west,
/turf/open/floor/iron/dark/side{
	dir = 10
	},
/area/ruin/space/has_grav/powered/speakeasy)
"vB" = (
/obj/machinery/computer/slot_machine,
/turf/open/floor/iron/dark/side{
	dir = 5
	},
/area/ruin/space/has_grav/powered/speakeasy)
"xI" = (
/obj/machinery/light/small/directional/west,
/turf/open/floor/iron,
/area/ruin/space/has_grav/powered/speakeasy)
"yh" = (
/obj/structure/chair/sofa/corp/left{
	dir = 4
	},
/turf/open/floor/mineral/plastitanium/red,
/area/ruin/space/has_grav/powered/speakeasy)
"yj" = (
/obj/machinery/computer/slot_machine,
/turf/open/floor/iron/dark/side{
	dir = 10
	},
/area/ruin/space/has_grav/powered/speakeasy)
"yB" = (
/obj/structure/table/wood,
/turf/open/floor/carpet/red,
/area/ruin/space/has_grav/powered/speakeasy)
"yJ" = (
/obj/structure/chair/stool/directional/west,
/turf/open/floor/carpet/red,
/area/ruin/space/has_grav/powered/speakeasy)
"zr" = (
/obj/machinery/light/red/dim/directional/east,
/turf/open/floor/iron/dark/side{
	dir = 5
	},
/area/ruin/space/has_grav/powered/speakeasy)
"zM" = (
/obj/machinery/light/red/dim/directional/east,
/turf/open/floor/iron/dark/smooth_edge{
	dir = 4
	},
/area/ruin/space/has_grav/powered/speakeasy)
"AM" = (
/turf/open/floor/iron/dark/side{
	dir = 10
	},
/area/ruin/space/has_grav/powered/speakeasy)
"Ba" = (
/mob/living/basic/trooper/syndicate/ranged/shotgun/space/stormtrooper/anthro/fox,
/obj/machinery/light/red/dim/directional/east,
/turf/open/floor/iron,
/area/ruin/space/has_grav/powered/speakeasy)
"BT" = (
/obj/structure/chair/sofa/corp/corner{
	dir = 4
	},
/turf/open/floor/carpet/red,
/area/ruin/space/has_grav/powered/speakeasy)
"BW" = (
/obj/machinery/door/airlock/wood,
/turf/open/floor/wood/tile,
/area/ruin/space/has_grav/powered/speakeasy)
"BZ" = (
/mob/living/basic/trooper/pirate/ranged,
/turf/open/floor/carpet/red,
/area/ruin/space/has_grav/powered/speakeasy)
"Ce" = (
/turf/open/floor/iron,
/area/ruin/space/has_grav/powered/speakeasy)
"Cu" = (
/obj/structure/chair/sofa/corp/left,
/obj/machinery/light/red/dim/directional/north,
/turf/open/floor/carpet/red,
/area/ruin/space/has_grav/powered/speakeasy)
"CN" = (
/obj/structure/chair/stool/directional/east,
/turf/open/floor/carpet/red,
/area/ruin/space/has_grav/powered/speakeasy)
"Dy" = (
/obj/structure/chair/stool/directional/east,
/turf/open/floor/iron/dark/side{
	dir = 10
	},
/area/ruin/space/has_grav/powered/speakeasy)
"DI" = (
/obj/structure/table/wood,
/turf/open/floor/carpet/green,
/area/ruin/space/has_grav/powered/speakeasy)
"Ei" = (
/obj/structure/chair/sofa/corp/corner,
/turf/open/floor/carpet/green,
/area/ruin/space/has_grav/powered/speakeasy)
"ES" = (
/turf/open/floor/iron/dark/smooth_large/airless,
/area/ruin/space/has_grav/powered/speakeasy)
"FB" = (
/obj/structure/chair/sofa/corp/right{
	dir = 4
	},
/turf/open/floor/mineral/plastitanium/red,
/area/ruin/space/has_grav/powered/speakeasy)
"FP" = (
/obj/machinery/door/airlock/gold,
/turf/open/floor/plating,
/area/ruin/space/has_grav/powered/speakeasy)
"Gm" = (
/turf/open/floor/plating,
/area/ruin/space/has_grav/powered/speakeasy)
"Gz" = (
/obj/structure/chair/stool/directional/east,
/turf/open/floor/iron/dark,
/area/ruin/space/has_grav/powered/speakeasy)
"GL" = (
/turf/open/floor/iron/dark/smooth_corner,
/area/ruin/space/has_grav/powered/speakeasy)
"GO" = (
/mob/living/basic/trooper/syndicate/melee/space/anthro/lizard,
/turf/open/floor/iron,
/area/ruin/space/has_grav/powered/speakeasy)
"Hv" = (
/obj/machinery/light/red/dim/directional/south,
/turf/open/floor/iron/dark/side{
	dir = 10
	},
/area/ruin/space/has_grav/powered/speakeasy)
"IJ" = (
/turf/template_noop,
/area/template_noop)
"IM" = (
/obj/structure/chair/sofa/corp/right,
/obj/machinery/light/red/dim/directional/north,
/turf/open/floor/carpet/red,
/area/ruin/space/has_grav/powered/speakeasy)
"JV" = (
/obj/machinery/door/airlock/multi_tile/glass,
/turf/open/floor/iron/dark,
/area/ruin/space/has_grav/powered/speakeasy)
"Kl" = (
/obj/machinery/light/red/dim/directional/north,
/turf/open/floor/wood/tile,
/area/ruin/space/has_grav/powered/speakeasy)
"KN" = (
/turf/open/floor/wood/tile,
/area/ruin/space/has_grav/powered/speakeasy)
"KY" = (
/obj/structure/chair/sofa/corp{
	dir = 4
	},
/turf/open/floor/carpet/red,
/area/ruin/space/has_grav/powered/speakeasy)
"LJ" = (
/obj/structure/chair/sofa/corp/left,
/mob/living/basic/trooper/syndicate/ranged/anthro,
/turf/open/floor/mineral/plastitanium/red,
/area/ruin/space/has_grav/powered/speakeasy)
"LU" = (
/obj/effect/mob_spawn/corpse/human/assistant,
/turf/open/floor/plating,
/area/ruin/space/has_grav/powered/speakeasy)
"Mf" = (
/obj/structure/chair/sofa/corp/corner{
	dir = 1
	},
/turf/open/floor/mineral/plastitanium/red,
/area/ruin/space/has_grav/powered/speakeasy)
"Mu" = (
/turf/open/floor/iron/dark/smooth_corner{
	dir = 4
	},
/area/ruin/space/has_grav/powered/speakeasy)
"MI" = (
/obj/machinery/light/red/dim/directional/south,
/turf/open/floor/wood/tile,
/area/ruin/space/has_grav/powered/speakeasy)
"MO" = (
/obj/structure/table/reinforced/plastitaniumglass,
/turf/open/floor/plating,
/area/ruin/space/has_grav/powered/speakeasy)
"Ne" = (
/obj/structure/chair/sofa/corp,
/turf/open/floor/mineral/plastitanium/red,
/area/ruin/space/has_grav/powered/speakeasy)
"OB" = (
/obj/machinery/light/red/dim/directional/east,
/turf/open/floor/iron,
/area/ruin/space/has_grav/powered/speakeasy)
"OL" = (
/turf/closed/wall/mineral/wood,
/area/ruin/space/has_grav/powered/speakeasy)
"OO" = (
/obj/machinery/light/red/dim/directional/north,
/turf/open/floor/iron/checker,
/area/ruin/space/has_grav/powered/speakeasy)
"OS" = (
/turf/open/floor/iron/dark/smooth_large,
/area/ruin/space/has_grav/powered/speakeasy)
"OW" = (
/obj/machinery/door/airlock/grunge,
/turf/open/floor/plating,
/area/ruin/space/has_grav/powered/speakeasy)
"PQ" = (
/obj/machinery/light/red/dim/directional/north,
/turf/open/floor/wood/parquet,
/area/ruin/space/has_grav/powered/speakeasy)
"Qb" = (
/obj/structure/chair/sofa/corp/corner,
/mob/living/basic/looter/big,
/turf/open/floor/carpet/red,
/area/ruin/space/has_grav/powered/speakeasy)
"QV" = (
/mob/living/basic/trooper/russian,
/obj/structure/chair/sofa/corp,
/turf/open/floor/carpet/green,
/area/ruin/space/has_grav/powered/speakeasy)
"Rp" = (
/turf/open/floor/light/colour_cycle/dancefloor_a,
/area/ruin/space/has_grav/powered/speakeasy)
"Sg" = (
/turf/open/floor/iron/dark/smooth_edge{
	dir = 4
	},
/area/ruin/space/has_grav/powered/speakeasy)
"ST" = (
/obj/machinery/computer/slot_machine,
/turf/open/floor/iron/dark,
/area/ruin/space/has_grav/powered/speakeasy)
"SW" = (
/obj/structure/falsewall,
/turf/open/floor/plating,
/area/ruin/space/has_grav/powered/speakeasy)
"SY" = (
/mob/living/basic/trooper/pirate,
/obj/structure/chair/sofa/corp/corner{
	dir = 4
	},
/turf/open/floor/carpet/green,
/area/ruin/space/has_grav/powered/speakeasy)
"Uc" = (
/turf/open/floor/carpet/red,
/area/ruin/space/has_grav/powered/speakeasy)
"Ug" = (
/obj/machinery/light/small/directional/east,
/turf/open/floor/wood/tile,
/area/ruin/space/has_grav/powered/speakeasy)
"UX" = (
/obj/machinery/roulette,
/turf/open/floor/carpet/green,
/area/ruin/space/has_grav/powered/speakeasy)
"Vc" = (
/turf/open/floor/iron/dark/smooth_corner{
	dir = 1
	},
/area/ruin/space/has_grav/powered/speakeasy)
"Ve" = (
/turf/open/floor/wood,
/area/ruin/space/has_grav/powered/speakeasy)
"Vo" = (
/turf/open/floor/iron/dark/smooth_edge{
	dir = 8
	},
/area/ruin/space/has_grav/powered/speakeasy)
"WJ" = (
/obj/machinery/light/red/dim/directional/south,
/turf/open/floor/iron,
/area/ruin/space/has_grav/powered/speakeasy)
"Xe" = (
/obj/structure/flora/rock/pile/jungle/style_random,
/turf/open/floor/grass/airless,
/area/ruin/space/has_grav/powered/speakeasy)
"Xo" = (
/obj/structure/chair/sofa/corp/right{
	dir = 1
	},
/turf/open/floor/mineral/plastitanium/red,
/area/ruin/space/has_grav/powered/speakeasy)
"XI" = (
/turf/open/floor/iron/dark/smooth_edge{
	dir = 1
	},
/area/ruin/space/has_grav/powered/speakeasy)
"Ye" = (
/obj/structure/chair/sofa/corp{
	dir = 8
	},
/turf/open/floor/carpet/red,
/area/ruin/space/has_grav/powered/speakeasy)
"Yw" = (
/turf/open/floor/iron/dark/smooth_corner{
	dir = 8
	},
/area/ruin/space/has_grav/powered/speakeasy)
"YK" = (
/obj/structure/table/wood/poker,
/turf/open/floor/carpet/red,
/area/ruin/space/has_grav/powered/speakeasy)
"YR" = (
/turf/open/floor/mineral/plastitanium,
/area/ruin/space/has_grav/powered/speakeasy)
"Zp" = (
/obj/machinery/light/red/dim/directional/north,
/turf/open/floor/iron,
/area/ruin/space/has_grav/powered/speakeasy)

(1,1,1) = {"
IJ
IJ
IJ
IJ
IJ
IJ
IJ
IJ
IJ
IJ
IJ
IJ
IJ
IJ
IJ
IJ
IJ
IJ
IJ
IJ
IJ
IJ
ES
ES
ES
ES
ES
IJ
ES
ES
ES
ES
ES
IJ
IJ
IJ
IJ
IJ
"}
(2,1,1) = {"
IJ
IJ
IJ
IJ
IJ
IJ
IJ
IJ
IJ
IJ
IJ
IJ
IJ
IJ
IJ
IJ
IJ
IJ
IJ
IJ
IJ
IJ
ES
Xe
jL
jL
ES
IJ
ES
jL
jL
Xe
ES
IJ
IJ
IJ
IJ
IJ
"}
(3,1,1) = {"
IJ
IJ
IJ
IJ
IJ
IJ
IJ
IJ
IJ
IJ
IJ
IJ
IJ
IJ
IJ
ES
ES
ES
ES
ES
ES
ro
ro
gw
gw
gw
ro
ro
ro
gw
gw
gw
ro
ro
ro
IJ
IJ
IJ
"}
(4,1,1) = {"
IJ
IJ
IJ
IJ
IJ
IJ
oQ
oQ
oQ
oQ
oQ
oQ
IJ
IJ
IJ
ES
Xe
jL
jL
jL
ES
ro
BT
KY
dr
Uc
ST
mq
yj
AM
AM
AM
vy
AM
ro
IJ
IJ
IJ
"}
(5,1,1) = {"
IJ
IJ
IJ
IJ
oQ
oQ
oQ
oQ
oQ
oQ
oQ
oQ
oQ
oQ
IJ
ES
jL
jL
Xe
Xe
ES
ro
Cu
yB
yB
Uc
cm
cm
cm
eK
eK
eK
eK
AM
ro
IJ
IJ
IJ
"}
(6,1,1) = {"
IJ
IJ
IJ
IJ
oQ
oQ
oQ
ro
ro
ro
ro
ro
ro
ro
ro
ro
ro
gw
gw
gw
ro
ro
lV
lV
lV
lV
lV
lV
lV
lV
lV
lV
eK
AM
gw
ES
ES
ES
"}
(7,1,1) = {"
IJ
IJ
oQ
oQ
oQ
oQ
oQ
ro
pB
FB
hD
yh
Mf
aV
LU
xI
aV
KN
KN
KN
KN
BW
eN
eN
eN
eN
eN
eN
YK
YK
dT
lV
eK
AM
gw
jL
jL
ES
"}
(8,1,1) = {"
IJ
IJ
oQ
oQ
oQ
oQ
oQ
ro
Ne
Rp
dh
Rp
tj
aV
Ce
Gm
aV
KN
cU
bP
KN
OL
lV
lV
lV
lV
lV
eN
Uc
YK
dT
lV
eK
AM
gw
Xe
jL
ES
"}
(9,1,1) = {"
oQ
oQ
oQ
oQ
oQ
oQ
oQ
ro
LJ
dh
Rp
dh
Xo
aV
Ce
Gm
aV
Kl
QV
DI
KN
OL
PQ
CN
CN
rD
lV
eN
YK
YK
dT
lV
eK
AM
ro
gw
gw
gw
"}
(10,1,1) = {"
oQ
oQ
oQ
ro
ro
ro
ro
ro
hD
Rp
dh
Rp
hD
aV
Gm
Gm
SW
KN
ch
DI
KN
OL
lV
YK
YK
dT
lV
eN
Uc
yJ
rD
lV
eK
AM
rr
Ve
oD
ro
"}
(11,1,1) = {"
oQ
oQ
oQ
ro
gZ
gZ
gZ
aV
OS
OS
OS
OS
OS
aV
Gm
Ce
aV
KN
Ei
uJ
KN
OL
lV
BZ
YK
dT
lV
eN
eN
eN
eN
lV
eK
Hv
ro
Ve
Ve
JV
"}
(12,1,1) = {"
oQ
oQ
oQ
ro
gZ
gZ
gZ
MO
GL
Vo
Vo
Vo
Mu
FP
Gm
Gm
aV
KN
KN
Ug
KN
OL
lV
Uc
YK
uv
lV
eN
eN
eN
eN
lV
eK
AM
ro
Ve
Ve
qM
"}
(13,1,1) = {"
oQ
oQ
oQ
ro
OO
gZ
gZ
MO
kI
YR
YR
YR
uP
aV
Gm
Gm
aV
OL
OL
OL
OL
OL
lV
YK
YK
dT
lV
eN
Uc
CN
rD
lV
eK
AM
rr
Ve
oD
ro
"}
(14,1,1) = {"
IJ
oQ
oQ
ro
gZ
gZ
nW
MO
XI
YR
YR
YR
uP
aV
fs
Ce
aV
KN
KN
KN
KN
OL
PQ
yJ
yJ
rD
lV
eN
YK
YK
dT
lV
eK
AM
ro
gw
gw
gw
"}
(15,1,1) = {"
IJ
oQ
oQ
ro
gZ
gZ
gZ
aV
Yw
zM
Sg
Sg
Vc
aV
Gm
Gm
aV
dw
SY
bP
KN
OL
lV
lV
lV
lV
lV
eN
Uc
YK
bY
lV
eK
AM
gw
Xe
jL
ES
"}
(16,1,1) = {"
IJ
oQ
oQ
ro
ro
aV
OW
aV
aV
aV
aV
FP
aV
aV
Ce
Gm
SW
KN
ch
UX
KN
BW
eN
eN
eN
eN
eN
eN
YK
YK
dT
lV
eK
AM
gw
Xe
jL
ES
"}
(17,1,1) = {"
IJ
oQ
oQ
oQ
ro
Ce
Ce
op
Ce
aV
Ce
Gm
Gm
Gm
Gm
Gm
aV
dw
Ei
sa
MI
OL
lV
lV
lV
lV
lV
lV
lV
lV
lV
lV
eK
AM
gw
ES
ES
ES
"}
(18,1,1) = {"
IJ
IJ
oQ
oQ
ro
Ce
Ce
Ce
Ce
OW
Gm
sN
Gm
Gm
Ce
Ce
aV
KN
KN
KN
KN
OL
IM
yB
yB
Uc
Gz
Dy
Dy
AM
AM
AM
gZ
AM
ro
IJ
IJ
IJ
"}
(19,1,1) = {"
IJ
IJ
oQ
oQ
ro
Zp
Ce
Ce
Ce
aV
aV
aV
aV
gA
aV
ro
ro
gw
gw
gw
ro
OL
Qb
Ye
lN
Uc
vB
ag
vB
eK
eK
eK
zr
qM
ro
IJ
IJ
IJ
"}
(20,1,1) = {"
IJ
IJ
IJ
oQ
ro
GO
Ce
Ce
Ce
aV
Ce
Ce
Ce
Ce
Ce
ro
Xe
jL
Xe
ES
ro
ro
ro
gw
gw
gw
ro
ro
ro
gw
gw
gw
ro
ro
ro
IJ
IJ
IJ
"}
(21,1,1) = {"
IJ
IJ
IJ
IJ
ro
Ce
Ce
Ce
Ce
aV
Zp
Ce
Ce
Ce
WJ
ro
jL
Xe
jL
ES
IJ
IJ
ES
jL
Xe
Xe
ES
IJ
ES
Xe
jL
jL
ES
IJ
IJ
IJ
IJ
IJ
"}
(22,1,1) = {"
IJ
IJ
IJ
IJ
ro
Ce
Ce
Ba
Ce
aV
Ce
Ce
OB
Ce
Ce
ro
jL
jL
jL
ES
IJ
IJ
ES
ES
ES
ES
ES
IJ
ES
ES
ES
ES
ES
IJ
IJ
IJ
IJ
IJ
"}
(23,1,1) = {"
IJ
IJ
IJ
IJ
ro
ro
ro
ro
ro
ro
ro
gw
ro
gw
ro
ro
ES
ES
ES
ES
IJ
IJ
IJ
IJ
IJ
IJ
IJ
IJ
IJ
IJ
IJ
IJ
IJ
IJ
IJ
IJ
IJ
IJ
"}
