//MAP CONVERTED BY dmm2tgm.py THIS HEADER COMMENT PREVENTS RECONVERSION, DO NOT REMOVE
"a" = (
/turf/closed/wall/r_wall,
/area/ruin/space/has_grav/tornvault)
"b" = (
/obj/item/stack/cable_coil,
/turf/open/floor/iron/airless,
/area/ruin/space/has_grav/tornvault)
"c" = (
/obj/machinery/door/airlock/multi_tile/metal{
	dir = 4;
	locked = 1;
	name = "Secure Tool Storage"
	},
/turf/open/floor/plating,
/area/ruin/space/has_grav/tornvault)
"d" = (
/turf/open/floor/iron/airless,
/area/ruin/space/has_grav/tornvault)
"e" = (
/obj/machinery/light/small/directional/west,
/obj/effect/turf_decal/tile/yellow/half{
	dir = 8
	},
/obj/structure/sign/departments/engineering/directional/west,
/turf/open/floor/iron/airless,
/area/ruin/space/has_grav/tornvault)
"f" = (
/obj/effect/decal/cleanable/glass,
/turf/open/floor/plating/airless,
/area/ruin/space/has_grav/tornvault)
"g" = (
/obj/machinery/light/directional/south,
/obj/effect/turf_decal/stripes/line,
/obj/structure/table,
/obj/item/storage/toolbox/mechanical{
	pixel_y = 4;
	pixel_x = -1
	},
/turf/open/floor/engine,
/area/ruin/space/has_grav/tornvault)
"h" = (
/obj/structure/table_frame,
/turf/open/floor/plating/airless,
/area/ruin/space/has_grav/tornvault)
"i" = (
/turf/open/floor/plating/airless,
/area/ruin/space/has_grav/tornvault)
"j" = (
/obj/effect/turf_decal/tile/yellow/half{
	dir = 8
	},
/turf/open/floor/iron/airless,
/area/ruin/space/has_grav/tornvault)
"l" = (
/obj/structure/cable,
/obj/effect/turf_decal/tile/yellow/half,
/turf/open/floor/iron/airless,
/area/ruin/space/has_grav/tornvault)
"n" = (
/obj/effect/decal/cleanable/glass,
/obj/item/shard,
/turf/open/floor/plating/airless,
/area/ruin/space/has_grav/tornvault)
"o" = (
/turf/closed/mineral/random/asteroid,
/area/ruin/unpowered/no_grav)
"r" = (
/obj/structure/cable,
/turf/open/floor/plating/airless,
/area/ruin/space/has_grav/tornvault)
"s" = (
/obj/item/stack/rods/two,
/turf/open/floor/iron/airless,
/area/ruin/space/has_grav/tornvault)
"t" = (
/obj/structure/cable,
/obj/machinery/power/apc/auto_name/directional/west,
/turf/open/floor/plating/airless,
/area/ruin/space/has_grav/tornvault)
"u" = (
/obj/effect/turf_decal/tile/yellow/opposingcorners{
	dir = 1
	},
/turf/open/floor/iron/checker,
/area/ruin/space/has_grav/tornvault)
"v" = (
/obj/machinery/light/directional/south,
/obj/effect/turf_decal/tile/yellow/half,
/turf/open/floor/iron/airless,
/area/ruin/space/has_grav/tornvault)
"w" = (
/obj/effect/turf_decal/stripes/line{
	dir = 10
	},
/obj/structure/closet/crate/engineering,
/obj/item/clothing/shoes/magboots{
	pixel_x = -4
	},
/obj/item/storage/pouch/material{
	pixel_y = -17;
	pixel_x = 1
	},
/turf/open/floor/engine,
/area/ruin/space/has_grav/tornvault)
"x" = (
/obj/effect/turf_decal/stripes/line{
	dir = 6
	},
/obj/machinery/power/energy_accumulator/grounding_rod,
/turf/open/floor/engine,
/area/ruin/space/has_grav/tornvault)
"z" = (
/obj/structure/table,
/obj/item/stack/rods/twentyfive,
/obj/effect/turf_decal/tile/yellow/half{
	dir = 1
	},
/turf/open/floor/iron/airless,
/area/ruin/space/has_grav/tornvault)
"A" = (
/obj/machinery/light/small/directional/west,
/obj/structure/sign/departments/engineering/directional/west,
/turf/open/floor/plating/airless,
/area/ruin/space/has_grav/tornvault)
"B" = (
/obj/effect/turf_decal/stripes/line{
	dir = 4
	},
/turf/open/floor/engine,
/area/ruin/space/has_grav/tornvault)
"C" = (
/obj/machinery/light/directional/north,
/obj/effect/turf_decal/stripes/line{
	dir = 1
	},
/obj/structure/table,
/obj/item/clothing/gloves/color/yellow{
	pixel_x = 0;
	pixel_y = 7
	},
/turf/open/floor/engine,
/area/ruin/space/has_grav/tornvault)
"D" = (
/obj/machinery/door/airlock/multi_tile/metal{
	dir = 4;
	locked = 1;
	name = "Secure Tool Storage"
	},
/obj/effect/turf_decal/stripes/full,
/turf/open/floor/plating,
/area/ruin/space/has_grav/tornvault)
"E" = (
/obj/effect/turf_decal/stripes/line{
	dir = 5
	},
/turf/open/floor/engine,
/area/ruin/space/has_grav/tornvault)
"F" = (
/obj/effect/turf_decal/stripes/full,
/turf/open/floor/plating,
/area/ruin/space/has_grav/tornvault)
"G" = (
/obj/effect/turf_decal/stripes/line{
	dir = 8
	},
/turf/open/floor/engine,
/area/ruin/space/has_grav/tornvault)
"H" = (
/obj/structure/table,
/turf/open/floor/iron/airless,
/area/ruin/space/has_grav/tornvault)
"I" = (
/obj/effect/spawner/structure/window/reinforced,
/turf/open/floor/plating,
/area/ruin/space/has_grav/tornvault)
"J" = (
/obj/effect/turf_decal/stripes/line{
	dir = 9
	},
/obj/machinery/power/emitter,
/turf/open/floor/engine,
/area/ruin/space/has_grav/tornvault)
"K" = (
/obj/effect/turf_decal/tile/yellow/half{
	dir = 1
	},
/turf/open/floor/iron/airless,
/area/ruin/space/has_grav/tornvault)
"L" = (
/obj/machinery/power/port_gen/pacman,
/turf/open/floor/plating/airless,
/area/ruin/space/has_grav/tornvault)
"M" = (
/turf/template_noop,
/area/template_noop)
"N" = (
/obj/structure/cable,
/turf/open/floor/iron/airless,
/area/ruin/space/has_grav/tornvault)
"P" = (
/obj/item/stack/sheet/glass,
/obj/structure/closet,
/obj/effect/turf_decal/tile/yellow/anticorner{
	dir = 1
	},
/turf/open/floor/iron/airless,
/area/ruin/space/has_grav/tornvault)
"Q" = (
/obj/effect/turf_decal/tile/yellow/anticorner{
	dir = 1
	},
/turf/open/floor/iron/airless,
/area/ruin/space/has_grav/tornvault)
"S" = (
/obj/item/shard,
/obj/item/stack/sheet/glass,
/obj/item/stack/sheet/glass,
/obj/machinery/light/directional/north,
/obj/structure/closet,
/turf/open/floor/plating/airless,
/area/ruin/space/has_grav/tornvault)
"T" = (
/obj/effect/turf_decal/tile/yellow/half,
/turf/open/floor/iron/airless,
/area/ruin/space/has_grav/tornvault)
"U" = (
/obj/effect/mob_spawn/corpse/human/assistant,
/obj/effect/turf_decal/tile/yellow/opposingcorners{
	dir = 1
	},
/turf/open/floor/iron/checker,
/area/ruin/space/has_grav/tornvault)
"V" = (
/obj/structure/closet/crate/engineering,
/obj/item/solar_assembly,
/obj/item/solar_assembly,
/obj/item/solar_assembly,
/obj/item/solar_assembly,
/obj/item/circuitboard/computer/solar_control,
/obj/item/stack/sheet/glass,
/obj/effect/turf_decal/tile/yellow/half{
	dir = 1
	},
/turf/open/floor/iron/airless,
/area/ruin/space/has_grav/tornvault)
"W" = (
/obj/item/stack/rods/ten,
/turf/open/floor/plating/airless,
/area/ruin/space/has_grav/tornvault)
"X" = (
/turf/open/floor/engine,
/area/ruin/space/has_grav/tornvault)
"Y" = (
/turf/open/floor/plating,
/area/ruin/space/has_grav/tornvault)
"Z" = (
/obj/structure/lattice,
/turf/template_noop,
/area/template_noop)

(1,1,1) = {"
M
M
M
M
o
o
o
o
M
M
M
M
"}
(2,1,1) = {"
M
M
o
o
o
o
o
o
o
o
M
M
"}
(3,1,1) = {"
M
o
o
a
a
a
a
a
a
o
o
M
"}
(4,1,1) = {"
M
o
a
a
a
a
a
a
a
a
o
M
"}
(5,1,1) = {"
o
o
a
a
a
a
a
a
a
a
o
o
"}
(6,1,1) = {"
o
o
a
a
J
G
G
w
a
a
o
o
"}
(7,1,1) = {"
o
o
a
a
C
X
X
g
a
a
o
o
"}
(8,1,1) = {"
o
o
a
a
E
B
B
x
a
a
o
o
"}
(9,1,1) = {"
o
a
a
a
a
F
D
a
a
a
a
o
"}
(10,1,1) = {"
o
a
Q
t
I
U
u
I
P
L
a
o
"}
(11,1,1) = {"
o
a
S
l
I
u
u
I
K
v
a
o
"}
(12,1,1) = {"
o
a
z
l
a
Y
c
a
W
T
a
o
"}
(13,1,1) = {"
o
a
V
N
A
j
j
e
d
T
a
o
"}
(14,1,1) = {"
o
a
i
r
N
N
i
d
d
T
a
o
"}
(15,1,1) = {"
M
a
i
d
s
r
b
H
d
n
a
M
"}
(16,1,1) = {"
M
Z
Z
n
i
i
s
h
f
Z
Z
M
"}
(17,1,1) = {"
M
M
M
Z
Z
i
i
Z
Z
M
M
M
"}
(18,1,1) = {"
M
M
M
M
M
Z
Z
M
M
M
M
M
"}
