"aD" = (/obj/structure/table/wood,/obj/item/clothing/glasses/regular{pixel_x = 0; pixel_y = -4},/turf/open/floor/carpet/green,/area/misc/hilbertshotel)
"aH" = (/obj/structure/chair/wood{dir = 8},/turf/open/floor/wood/tile,/area/misc/hilbertshotel)
"bc" = (/obj/effect/turf_decal/weather/dirt,/obj/effect/light_emitter/interlink,/turf/open/floor/grass,/area/misc/hilbertshotel)
"bl" = (/obj/structure/bookcase/random/adult,/obj/structure/curtain/cloth/fancy,/turf/open/floor/wood/large,/area/misc/hilbertshotel)
"bM" = (/turf/closed/wall/mineral/stone,/area/misc/hilbertshotel)
"ci" = (/obj/machinery/light/small/directional/west,/obj/effect/turf_decal/siding/wood,/obj/effect/turf_decal/siding/wood{dir = 1},/turf/open/floor/wood,/area/misc/hilbertshotel)
"cN" = (/obj/structure/easel,/turf/open/floor/wood/tile,/area/misc/hilbertshotel)
"cO" = (/obj/structure/table/wood,/obj/effect/turf_decal/siding/wood{dir = 1},/turf/open/floor/wood,/area/misc/hilbertshotel)
"df" = (/obj/effect/turf_decal/weather/dirt{dir = 1},/obj/structure/flora/tree/jungle/small/style_random,/obj/effect/light_emitter/interlink,/turf/open/floor/grass,/area/misc/hilbertshotel)
"eD" = (/obj/structure/table/wood,/obj/item/paper_bin{pixel_x = -6; pixel_y = 5},/turf/open/floor/carpet/green,/area/misc/hilbertshotel)
"fn" = (/turf/closed/indestructible/hoteldoor{icon_state = "door_closed"; icon = 'icons/obj/doors/puzzledoor/default.dmi'},/area/misc/hilbertshotel)
"gx" = (/obj/structure/flora/rock/pile/jungle/style_2,/obj/effect/turf_decal/weather/dirt{dir = 1},/obj/effect/light_emitter/interlink,/turf/open/floor/grass,/area/misc/hilbertshotel)
"jo" = (/obj/structure/window/green_glass_pane,/obj/structure/curtain/cloth/fancy,/turf/closed/wall/mineral/stone,/area/misc/hilbertshotel)
"ju" = (/obj/machinery/light/warm/dim/directional/north,/turf/open/floor/carpet/red,/area/misc/hilbertshotel)
"kv" = (/turf/open/floor/wood/tile,/area/misc/hilbertshotel)
"mS" = (/obj/machinery/light_switch/directional/south,/turf/open/floor/carpet/red,/area/misc/hilbertshotel)
"oy" = (/obj/machinery/light/small/directional/east,/obj/effect/turf_decal/siding/wood,/obj/effect/turf_decal/siding/wood{dir = 1},/turf/open/floor/wood,/area/misc/hilbertshotel)
"oG" = (/obj/structure/chair/wood,/turf/open/floor/wood/tile,/area/misc/hilbertshotel)
"pc" = (/obj/structure/chair/office/light{dir = 1},/turf/open/floor/wood/tile,/area/misc/hilbertshotel)
"rO" = (/obj/effect/turf_decal/weather/dirt,/obj/structure/flora/rock/pile/jungle/style_5,/obj/effect/light_emitter/interlink,/turf/open/floor/grass,/area/misc/hilbertshotel)
"sW" = (/obj/structure/table/wood,/obj/item/flashlight/lamp/green{pixel_x = -8; pixel_y = 10},/turf/open/floor/carpet/green,/area/misc/hilbertshotel)
"tp" = (/obj/machinery/light/warm/dim/directional/south,/turf/open/floor/carpet/red,/area/misc/hilbertshotel)
"wb" = (/turf/closed/indestructible/wood,/area/misc/hilbertshotel)
"wj" = (/obj/structure/chair/wood{dir = 4},/turf/open/floor/wood/tile,/area/misc/hilbertshotel)
"wn" = (/obj/effect/turf_decal/weather/dirt,/obj/structure/flora/rock/pile/jungle/style_3,/obj/effect/light_emitter/interlink,/turf/open/floor/grass,/area/misc/hilbertshotel)
"wP" = (/obj/effect/light_emitter/interlink,/turf/open/misc/dirt,/area/misc/hilbertshotel)
"xY" = (/obj/effect/turf_decal/siding/wood{dir = 6},/turf/open/floor/wood,/area/misc/hilbertshotel)
"yS" = (/obj/effect/turf_decal/siding/wood{dir = 9},/obj/effect/turf_decal/siding/wood,/turf/open/floor/wood,/area/misc/hilbertshotel)
"ze" = (/obj/effect/turf_decal/siding/wood,/obj/effect/turf_decal/siding/wood{dir = 5},/turf/open/floor/wood,/area/misc/hilbertshotel)
"zP" = (/obj/effect/turf_decal/weather/dirt{dir = 1},/obj/effect/light_emitter/interlink,/turf/open/floor/grass,/area/misc/hilbertshotel)
"Ba" = (/obj/structure/table/wood,/obj/item/folder{pixel_x = 4; pixel_y = 4},/turf/open/floor/carpet/green,/area/misc/hilbertshotel)
"Bz" = (/obj/effect/turf_decal/siding/wood,/obj/effect/turf_decal/siding/wood{dir = 1},/turf/open/floor/wood,/area/misc/hilbertshotel)
"CB" = (/obj/structure/bookcase/random/religion,/turf/open/floor/wood/large,/area/misc/hilbertshotel)
"Dt" = (/obj/structure/table/wood,/obj/item/pen/fountain{pixel_x = -5; pixel_y = 8},/turf/open/floor/carpet/green,/area/misc/hilbertshotel)
"DZ" = (/obj/machinery/door/airlock/wood,/turf/closed/wall/mineral/stone,/area/misc/hilbertshotel)
"Fh" = (/turf/open/floor/carpet/red,/area/misc/hilbertshotel)
"Fm" = (/obj/effect/turf_decal/weather/dirt,/obj/structure/flora/tree/jungle/small/style_random,/obj/effect/light_emitter/interlink,/turf/open/floor/grass,/area/misc/hilbertshotel)
"HI" = (/obj/structure/bookcase/random/reference,/turf/open/floor/wood/large,/area/misc/hilbertshotel)
"Il" = (/obj/structure/table/wood,/turf/open/floor/carpet/green,/area/misc/hilbertshotel)
"JB" = (/obj/effect/turf_decal/weather/dirt,/obj/structure/chair/sofa/bench/right,/obj/effect/light_emitter/interlink,/turf/open/floor/grass,/area/misc/hilbertshotel)
"KI" = (/obj/structure/table/wood,/obj/effect/turf_decal/siding/wood{dir = 1},/obj/item/paper_bin{pixel_x = -2; pixel_y = 6},/turf/open/floor/wood,/area/misc/hilbertshotel)
"Lk" = (/obj/effect/turf_decal/weather/dirt,/obj/structure/chair/sofa/bench/left,/obj/effect/light_emitter/interlink,/turf/open/floor/grass,/area/misc/hilbertshotel)
"Lr" = (/obj/effect/turf_decal/siding/wood{dir = 5},/obj/effect/turf_decal/siding/wood,/turf/open/floor/wood,/area/misc/hilbertshotel)
"MM" = (/obj/structure/chair/comfy/beige{dir = 4},/obj/effect/turf_decal/siding/wood{dir = 9},/turf/open/floor/wood,/area/misc/hilbertshotel)
"NG" = (/obj/structure/closet/crate/bin,/obj/effect/turf_decal/siding/wood,/turf/open/floor/wood,/area/misc/hilbertshotel)
"NU" = (/obj/machinery/light_switch/directional/north,/turf/open/floor/carpet/red,/area/misc/hilbertshotel)
"PL" = (/obj/structure/bookcase/random/nonfiction,/turf/open/floor/wood/large,/area/misc/hilbertshotel)
"Sq" = (/obj/structure/window/green_glass_pane,/obj/structure/curtain/cloth/fancy,/turf/open/floor/wood/tile,/area/misc/hilbertshotel)
"St" = (/obj/structure/table/wood,/obj/item/flashlight/lamp/green{pixel_x = 12; pixel_y = 2},/turf/open/floor/carpet/green,/area/misc/hilbertshotel)
"TX" = (/obj/structure/displaycase/trophy,/turf/open/floor/wood/tile,/area/misc/hilbertshotel)
"UL" = (/obj/structure/chair/comfy/black{dir = 8},/obj/effect/turf_decal/siding/wood{dir = 5},/turf/open/floor/wood,/area/misc/hilbertshotel)
"Vk" = (/obj/structure/bookcase/random/fiction,/turf/open/floor/wood/large,/area/misc/hilbertshotel)
"Yi" = (/obj/effect/turf_decal/siding/wood{dir = 10},/turf/open/floor/wood,/area/misc/hilbertshotel)
"Zc" = (/obj/machinery/computer/libraryconsole/bookmanagement,/obj/structure/table/wood,/obj/effect/turf_decal/siding/wood,/turf/open/floor/wood,/area/misc/hilbertshotel)

(1,1,1) = {"
bMbMbMbMjojobMbMbMbMjojobMbMbMbM
bMwnbcbcbcbcJBLkbcFmbcbcbcbcrObM
DZwPwPwPwPwPwPwPwPwPwPwPwPwPwPDZ
bMzPzPdfzPzPzPzPzPzPgxzPzPzPzPbM
wbSqSqwbSqSqwbSqSqwbSqSqwbSqSqwb
wbNGxYjuFhFhNUFhFhFhFhFhjuYiZcwb
wbcNkvkvkvFhkvoGoGkvFhkvkvkvpcwb
wbblHIHITXFhwjaDIlaHFhTXHIHIHIwb
wbciBzLrkvFhwjIlsWaHFhkvySBzoywb
wbPLPLPLTXFhwjDteDaHFhTXCBCBCBwb
wbciBzzekvFhwjStIlaHFhkvySBzoywb
wbVkVkVkTXFhwjIlBaaHFhTXPLPLPLwb
wbkvkvkvkvFhkvkvkvkvFhkvkvkvkvwb
wbKIULtpFhFhFhFhmSFhFhFhtpMMcOwb
wbwbwbwbwbwbwbfnwbwbwbwbwbwbwbwb
"}
